
      32222223
      1      e
      1      e
      1      1
      1      1
      10     1
      32222223
