






        322223
        1   51
        1    1
        1  223dd322223
        1     0      1
        1            e
        1            e
        1 5      4   1
        32222222222223
